Tile Map 0 (explored area):
   #      ## 
 ##.##   W.. 
#.....# # .. 
 ###..##.... 
#...........#
#......G....#
#..##..#.... 
 #.##......# 
 #.........# 
  ### X ###  
