Tile Map 16 (explored area):
   ##     ## 
 ##..#   W..#
#.....# ##..#
 ###..##....#
#...........#
#...........#
#..# . #G...#
 #. #......# 
 #.........# 
      X####  
