Tile Map 5 (explored area):
    ###      
   ....##### 
  #......G..#
 #..........#
#...........#
#.L.........#
#..X.......# 
 #.#.......# 
  # #######  
