Tile Map 30 (explored area):
      ###   
 #####...X  
#........## 
#..........#
#..........#
#........#.#
 #.........#
 #.......#.#
  ####### # 
