Tile Map 48 (explored area):
    #      
 W.#.##### 
 #X...GG..#
 ##.......#
#.........#
#.........#
#.#......# 
 #.......# 
  #######  
