Tile Map 15 (explored area):
       ###   
  #####..X   
 #......#.W  
#..#####..WW 
#.#G......## 
#...........#
 #..........#
 #.......##.#
  #.#####...#
   #......#.#
        ## # 
