Tile Map 39 (explored area):
         ####   
        #....#  
        #....## 
        #......#
        #......#
        #G.....#
       ##......#
      #..G.....#
     ##.G......#
    #.....G..## 
   ##........#  
  #........##   
 ##........#    
#..........#    
#..........#    
 ##......##     
  #......#      
  #......#      
  #......#      
   ##..##       
     WX         
