Tile Map 4 (explored area):
         #  ##   
        #.....#  
        #.....## 
        #.......#
         .......#
         .......#
       ##.......#
      #.........#
     ##..G......#
    #........### 
   ##...G.....#  
  #.........##   
 ##.........#    
#...........#    
#...........#    
  #.......##     
  #.......#      
  #......#       
  #.......#      
   # ...##       
     WWX         
