Tile Map 1 (explored area):
         ####   
        #....#  
        #....## 
        #......#
        #......#
        #......#
       ##......#
      #.G......#
     ##........#
    #........## 
   ##........#  
  #........##   
 ##........#    
#..........#    
#..........#    
 ##......##     
  #......#      
  #......#      
  #......#      
   ##..##       
     XW         
