Tile Map 40 (explored area):
 #   #       
#...### #    
#..#...#.#   
#.###..G..#  
#.####....#  
#.#....#.#   
#........G#  
 ###.#...#   
  #..####  # 
   ........G#
  #......... 
    ##X    # 
