Tile Map 53 (explored area):
         ## #  # 
        #..##... 
        #..#.#.. 
        #..#.##. 
        #......# 
        #......# 
        #G##...# 
         #.....# 
        ##.....# 
       #......#.#
      ##.....#   
     #.....##.   
    ##.....# .   
 ###.......# .   
#..#.......#..   
#....#.....# #   
 ##..#...##.     
  #..#...#..#    
  #..#...#       
  #.#..##.       
   #.W.WWW       
    XWW          
