Tile Map 23 (explored area):
   ##     ## 
 ##..#   W..#
#.....# ##.. 
 ####.##.... 
#...G....... 
 .. ........ 
#..#...#G...#
 #.#.......# 
 #.........# 
  ##W X      
