Tile Map 43 (explored area):
       ##   
   ## #..W  
 ##..#...X# 
#G.........#
#..........#
#........#.#
 #.........#
 #.......#.#
 ####..## # 
      #     
