Tile Map 21 (explored area):
  ###      
 X...#   # 
 W........ 
 W.#......#
WW..#####  
#.....G..# 
 ........# 
 ........# 
 ........# 
 .......#  
#.......#  
  ######   
