Tile Map 4 (explored area):
 ##     ##   
#..X   #..   
#..## #..G#  
#....##..### 
#....G....G.#
#...........#
#.......##..#
 #......##.# 
 #.........# 
  ####W####  
