Tile Map 44 (explored area):
           # 
   ##    W..#
 ##..#   W..#
#.....# ##..#
 ###..##.... 
#........... 
#......#G... 
#..##..#G..# 
 #. #.... .  
 #.........# 
  #   X      
