Tile Map 49 (explored area):
 ##     ##   
#..W   #..   
#..## #..G#  
#....##..### 
#....GG...G.#
#...........#
#.......##..#
 #......##.# 
 #.........# 
  ####X ###  
