Tile Map 5 (explored area):
   # #      
W.X.#.##### 
###....G.G.#
#..........#
#..........#
#..........#
#.........# 
#.......#.# 
 ####### #  
