Tile Map 6 (explored area):
 ##     ##   
#..W   #..   
#..## #..G#  
#....##..### 
#.....G...G.#
#...........#
#.......##..#
 #......##.# 
 #.........# 
  ####X ###  
