Tile Map 35 (explored area):
   ##     ## 
 ##..#   W..#
#.....# ##..#
 ###..##....#
#.....#.....#
#...........#
#..##..#G...#
 #.##......# 
 #.........# 
  ####X####  
      W      
