Tile Map 29 (explored area):
   ##     ## 
 ##..#   W..#
#.....# ##..#
 ###..##....#
#...........#
#...........#
#..##..#....#
 #.##......# 
 #.........# 
  ####X####  
